. ......
.     ..
.... ...
..     .
......*.