. ......
.    $..
.... ...
..$    .
......*.