.   .....................................................................
.   .               .               .           .                   .   .
.   .   .........   .   .....   .........   .....   .....   .....   .   .
.               .       .   .           .           .   .   .       .   .
.........   .   .........   .........   .....   .   .   .   .........   .
.       .   .               .           .   .   .   .   .           .   .
.   .   .............   .   .   .........   .....   .   .........   .   .
.   .               .   .   .       .           .           .       .   .
.   .............   .....   .....   .   .....   .........   .   .....   .
.           .       .   .       .   .       .           .   .           .
.   .....   .....   .   .....   .   .........   .   .   .   .............
.       .       .   .   .       .       .       .   .   .       .       .
.............   .   .   .   .........   .   .....   .   .....   .....   .
.           .   .           .       .   .       .   .       .           .
.   .....   .   .........   .....   .   .....   .....   .............   .
.   .       .           .           .       .   .   .               .   .
.   .   .........   .   .....   .........   .   .   .............   .   .
.   .           .   .   .   .   .           .               .   .       .
.   .........   .   .   .   .....   .........   .........   .   .........
.   .       .   .   .           .           .   .       .               .
.   .   .....   .....   .....   .........   .....   .   .........   .   .
.   .                   .           .               .               .   .
...*.....................................................................